# # # # # # # # # #
# x t x x x x x x #
# x x x c x x x x #
# x x x x x x x p #
# # # # # # # # # #